ooooooooo^^ooooooooo
o______xx..xx______o
o______xx..xx______o
o_xxxxxxx..xxxxxx__o
o_xxm..........xx__o
o_xx..xxxxxm...xx__o
o_xx..xx.....m.xx__o
o_xx..xx$..m...xx__o
o_xx.mxx.m.....xx__o
o_xx..xx....m..xx__o
o_xx..xx.m..cxxxx__o
o_xx..xxxxxxxxxxx__o
o_xx..xxxN.....xx__o
o_xx.......xxQ.xx__o
o_xx...m...xx.Pxx__o
o_xxxxxxxxxxxxxxx__o
o__________________o
o__________________o
oooooooooooooooooooo
